NO ./textures/colorstone.xpm
SO ./textures/redbrick.xpm
WE ./textures/wood.xpm
EA ./textures/greystone.xpm

F 53,39,92
C 85,177,217

11111111111111111111111111111111
11111111000000000110000000000001
11111111011000001110000000000001
1111111100100000000000000N000001
11111111101100000111000000000001
10000000001100000111011110111111
11110111111111011100000010001
11110111111111011101010010001
11000000110101011100000010001
10000000000000001100000010001
10000000000000001101010010001
1100000111010101111101111000111
11110111 1110101 101111010001
11111111 1111111 111111111111
