NO ./textures/sparcles.xpm
SO ./textures/crasota.xpm
WE ./textures/dark.xpm
EA ./textures/what.xpm

F 53,39,92 
C 255,177,217

1111111111111111111111111111111111111111111111111111111111111111111111111111111
1000000000000000000011111111111111000100011100011100000000000000000000000000001
1000000000000000000011111111111111100000000000001100000000000000000000000000001
1000000100010010000000000000111111111000000011000100000000000000000000000000001
1000000000000000000000000000111111111110000000000100000000000000000000000000001
1000000000000000000000000000111111111111100011100100000000000000000000000000001
1000000000000000000010000000000000011111110001000100000000000000000000000000001
1000000000000000000010000001000000011111111000001100000000000000000000000000001
10000000000000000000111111111110001111111111000011000000000000000N0000000000001
1000000000000000000010000000000000111111111110011100000000000000000000000000001
1111111110011111111100000000000000000001000000000000000000000000000000000000001
1111111110011111111100000000000200000000000000000000000000000000000000000000011
1111111110011111111100001001000111111111111100000000000000000000000000000001111
1111111110011111111100000000000111110000000000110000000000000000000000000001111
1111111110011111111111111111111111110000010001110000000000000000000000000000111
1111111110011111111111111111111111110000010001110000000000000000000000000000111
1111111110011111111111111111111111110000111111110000000000000000000000000000111
1111110000000000000000000000000000000000111111110000000000000000000000000000111
1111110000000000000000000000000000000000111111110000000000000000000000000000111
1111110000000000000000000000000000000000111111110000000000000000000000000000111
1111110000000000000000000000000000000000111111110000000000000000000000000000001
1111111111111111111111111111111111111111111111111111111111111111111111111111111